x x x x x x x x x x x x x x x x x x x x x x x x x x x x
x * * * * * * * * * * * * x x * * * * * * * * * * * * x
x * x x x x * x x x x x * x x * x x x x x * x x x x * x
x b x x x x * x x x x x * x x * x x x x x * x x x x b x
x * x x x x * x x x x x * x x * x x x x x * x x x x * x
x * * * * * * * * * * * * * * * * * * * * * * * * * * x
x * x x x x * x x * x x x x x x x x * x x * x x x x * x
x * x x x x * x x * x x x x x x x x * x x * x x x x * x
x * * * * * * x x * * * * x x * * * * x x * * * * * * x
x x x x x x * x x x x x h x x h x x x x x * x x x x x x
h h h h h x * x x x x x h x x h x x x x x * x h h h h h
h h h h h x * x x h h h h h h h h h h x x * x h h h h h
h h h h h x * x x h x h h h h h h x h x x * x h h h h h
h h h h h x * x x h x h g h h b h x h x x * x h h h h h
h h h h h x * h h h x h h h h h h x h h h * x h h h h h
h h h h h x * x x h x h h h h h h x h x x * x h h h h h
h h h h h x * x x h x x x x x x x x h x x * x h h h h h
h h h h h x * x x h h h h h h h h h h x x * x h h h h h
h h h h h x * x x x x x h x x h x x x x x * x h h h h h
x x x x x x * x x x x x h x x h x x x x x * x x x x x x
x * * * * * * x x * * * * x x * * * * x x * * * * * * x
x * x x x x * x x * x x x x x x x x * x x * x x x x * x
x * x x x x * x x * x x x x x x x x * x x * x x x x * x
x * * * * * * * * * * * * p * * * * * * * * * * * * * x
x * x x x x * x x x x x * x x * x x x x x * x x x x * x
x b x x x x * x x x x x * x x * x x x x x * x x x x b x
x * x x x x * x x x x x * x x * x x x x x * x x x x * x
x * * * * * * * * * * * * x x * * * * * * * * * * * * x
x x x x x x x x x x x x x x x x x x x x x x x x x x x x
